XXXXXXXXXXXXXXXX
XS0000000000000X
X00000000000000X
X00XXX00X000X00X
X0X00000XX0XX00X
X00XX000X0X0X00X
X0000X00X000X00X
X0XXX000X000X00X
X00000000000000X
X0X00X00X00X000X
X0X00X00X0X0000X
X0XXXX00XX00000X
X0000X00X0X0000X
X0000X00X00X000X
X00000000000000X
X0000000000000GX
XXXXXXXXXXXXXXXX