BBBBBBBBBBBBBBBB
BSMMMMMMMMMMMMMB
BMMMMMMMMMMBBMMB
BMMBBBMMMMMBBMMB
BMMBBBMMMMMMMMMB
BMMBBBMMMMMMMMMB
BMMBBBMMMBBBMMMB
BMMBBBMMMBBBMMMB
BMMMMMMMMBBBMMMB
BMMMMMMMMBBBMMMB
BMMMMMMMMMBBMMMB
BMMMMBMMMMMMMMMB
BMMMBBBMMMMMMMMB
BMMBBBBBMMMMMMMB
BMMMMMMMMMMMMMOB
BBBBBBBBBBBBBBBB