BBBBBBBBBBBBBBBB
BSBMBMMMMMMMBBMB
BMBMMMBBBBBMBMMB
BMBMBMBBBBMMBMBB
BMBMBMBMMMMMMMMB
BMMMBMBMBMBBBBBB
BMBMBMBMBMMMMMMB
BMBMBBBMBMBBBBBB
BMBMMMBMMMMMMMMB
BMBMBMBMBBBBBMMB
BBBMBBBMBMMMMMMB
BMMMBMMMBMBBBBBB
BMBBBMBMBMMMMMMB
BMBMMMBBBBBMBBMB
BMMMMBBMMMMMMBOB
BBBBBBBBBBBBBBBB