BBBBBBBBBBBBBBBBBBBBBBBBBB
BSMMMMBMMMMMMMMMMMMMMMMMMB
BMMMMMBMMMMMMMMMMMMMBBMMMB
BMMBMMMMMMMMMMMMMMMMMMMMMB
BMMMMMBMMMMMBMMMMBBMMMMMMB
BMMMMMBBBBBBBMMMMMMMMMMMMB
BBMBBBBMMMMMBMMMMMMMMMMMMB
BMMMMMMMMMMMBMMMBBBBBBBBBB
BMMMMMMMMMMMBMMMMMMBMMMMMB
BBBBMMMMMMMMBMMMBMMMMMMMMB
BMMBMMMMMMMMMMMBBMMBMMMMMB
BMMBMMBBBBBBBMMMMMMMMBBMMB
BMMMMMMMMMMMBMMMBMMBMMMMMB
BMMMMMMMMMMMBBBBBBMBBBBMBB
BMMMMMMMMMMMMMMMMMMBMMMMMB
BMMMBMMMMMMMMMMMMMMBMMMMMB
BMMMMMMMMMMMMMMMMMMBMMMMMB
BMMMMMMMBMMMMMMMMMMBMMMMMB
BMMMMMMMBBBBBBBBBBBBMMMMMB
BMMMMMMMBMMMMMMMMMBMMMMMMB
BMMMMMMMBMMMMMMMMMBMBBBBBB
BMMMMMMMBMMMMMMMBMMMMMMMMB
BMMMMMMMMMMMMMMMBMMMMMMMMB
BMMMMMMMBMMMMMMMBMMMMMMMOB
BBBBBBBBBBBBBBBBBBBBBBBBBB